

111111111111111
222222
   3333333333
44444444
55
66666666
777777
8888888888888888888888888
9999
                     *******
