11111111111111111111
1P0000010000000000C1
10000001000000000001
10000001000000000001
10000001000000000001
10000001000000000001
100000010000000000E1
11111111111111111111

